#MAPID 00
#NAME World Map
#WIDTH 50
#HEIGHT 40
#TILESET 00
#MAPFLOOR
~~~~~~~~~~~~~~~~~~~~~~~~~~~~~~~~~~~~~~~~~~~~~~~~~
~~~~~~~~~~~///////////~~~~~~~~~~~~~~~~~~~~~~~~~~~
~~~~~~~~~/@@`````````@@@@~~~~~~~~~~~~~~~~~~~~~~~~
~~~~~~~/@```````````````@@```````~~~~~~~~~~~~~~~~
~~~~//````_VV_`````````````````````@@@~~~~~~~~~~~
~~~//@````____`````````````````//D//////~~~~~~~~~
~~~//@````````````````````````````/////D/@@~~~~~~
~~~~/```````````````@@``````````//////`````@@~~~~
~~~~/````````````````@@````///////////````@@@@~~~
~~~~~/`````````````````/////////////`````````@~~~
~~~~~~//`````````@@```////////```````````````@~~~
~~~~~~~//``````@@@/////////````````````````@@`~~~
~~~~~~~~/@@@@@@@@//////@@@@@@```````````@@@``~~~~
~~~~~~~~~//@@@@@@@@@///////@@@@@`````@@@@@``~~~~~
~~~~~~~~~////@@@@@///``````````@@@@`@@@@@@~~~~~~~
~~~~~~~~///////V@//D///``````@@@@@@@@@@@@~~~~~~~~
~~~~~@@@@@@///////``````````@@`````@@@~~~~~~~~~~~
~~~~@@@`@@@@@@@////////@@@@@```````~~~~~~~~~~~~~~
~~@@@@@@```@@@@@@@@@/D///`````````~~~~~~~~~~~~~~~
~@@@@@````@@```@@@@```///////```~~~~~~~~~~~~~~~~~
~@@```@@``````~~~~~~~///@@/////~~~~~``~~~~~~~~~~~
~@``````````~~~~~~~~~//@@@@@`D//~~~````~~~~~~~~~~
~```````````~~~~~~~~~/@@@@//``//~~~``~~~~~~~~~~~~
~~```````````~~~~~///@@@@@/////~~~~~~~~~~~~~~~~~~
~~~```V``````@@@``@@@@@@@//////~~~~~~~~~~~~~~~~~~
~~~````````````@@```@@@/////////////~~~~~~~~~~~~~
~~~~@```````@@```///////////////////////~~~~~~~~~
~~~~~@``````@////////////D///////@@@@@@@~~~~~~~~~
~~~~~~//@@````//////////@@@@@@@@@@@@@@@@@~~~~~~~~
~~~~~~~///`///////////////@@@V@@@@@@@@@@~~~~~~~~~
~~~~~~~~/////////////@@@@@@@@@@@@@@@@@@@~~~~~~~~~
~~~~~~~~////////////@@@@@@@``@@@@@@@@``@~~~~~~~~~
~~~~~~~~~/////////@@@@@@@@@@``````````@@@@~~~~~~~
~~~~~~~~~~~~~~~~@@@@`````@@`````````````@@@@@@~~~
~~~~~~~~~~~~~~``````````````````````````````@@~~~
~~~~~~````~~~~~~~~````````````@@@`````D``````@~~~
~~~~~~~~```~~~~~~~~`````````````````````````@@~~~
~~~~`~~~~~~~~~~~~~~~~~~~~~@@`````````````@@@~~~~~
~~~~~~~~~~~~~~~~~~~~~~~~~~~~~````````````~~~~~~~~
~~~~~~~~~~~~~~~~~~~~~~~~~~~~~~~~~~~~~~~~~~~~~~~~~
#OBJECTS
E<11,04>00:10<14,13> ; KINGDOM VILLAGE
E<12,04>01:10<15,13> : KINGDOM VILLAGE
E<15,15>02:F1<01,01> ; VILLAGE 1 IN FOREST
E<33,05>03:00<39,07> ; DUNGEON 01 ENTRANCE
E<39,06>04:00<33,06> ; DUNGEON 01 EXIT
E<19,15>05:00<21,19> ; DUNGEON 02 ENTRANCE
E<21,18>06:00<19,16> ; DUNGEON 02 EXIT
E<06,24>07:F1<01,01> ; VILLAGE 2 IN PLAINS
E<29,21>09:00<25,28> ; DUNGEON 03 ENTRANCE
E<25,27>08:00<29,22> ; DUNGEON 03 EXIT
E<29,29>0A:F1<01,01> ; VILLAGE 3 IN PLAINS
E<38,35>0B:F1<01,01> ; SATAN CASTLE
